BUI	KEYWORD1
Control	KEYWORD1
Button	KEYWORD1
Label	KEYWORD1
CheckBox	KEYWORD1
Slider	KEYWORD1
NumericUpDown   KEYWORD1

calibrateTouch	KEYWORD2
setPosition	KEYWORD2
setOnClickHandler	KEYWORD2
setFont	KEYWORD2
setText	KEYWORD2
getType	KEYWORD2
checkTouched	KEYWORD2
draw	KEYWORD2
enabled	KEYWORD2
checked	KEYWORD2
minValue	KEYWORD2
maxValue	KEYWORD2
setValue	KEYWORD2
enableDarkmode	KEYWORD2

UNDEFINED	LITERAL1
BUTTON	LITERAL1
LABEL	LITERAL1
CHECKBOX	LITERAL1
NUMUD	LITERAL1
